NO texture/north.xpm
SO texture/south.xpm
WE texture/west.xpm
EA texture/east.xpm

F 255, 255, 0
C 255, 255, 0

11111
10001
10N01
10001
11111