NO texture/north.xpm
SO texture/south.xpm
WE texture/west.xpm
EA texture/east.xpm

F 255, 255, 0
C 255, 255, 0

11111111111111
10000000000001
 11100N001111
   10000011
   10000001
   10000011
   1111111