NO texture/north.xpm
SO texture/dirt.xpm
WE texture/book.xpm
EA texture/book.xpm

F 220, 100, 0
C 30, 30, 255

111111111111
100000000001
100000011111
1000000000011111
1000000000000001
1000000000000001
100000N000000001
100000000001111
100000000001
111111111111